dimentionality	dimensionality
reveale	reveal
drived	drove
adovocate	advocate
informe	inform
devide	divide
ingenius	ingenious
amatuer	amateur
appologize	apologize
spontanous	spontaneous
scarely	scarcely
accustome	accustom
discloser	disclosure
infrare	infrared
finaly	finally
modefication	modification
partical	partial
remenber	remember
infomation	information
occurre	occur
likability	likeability
forcast	forecast
artical	article
interfer	interfere
insentive	incentive
lieing	lying
quarternary	quaternary
fomula	formula
artifical	artificial
insted	instead
wittle	whittle
decid	decide
grante	grantee
seperate	separate
parmanent	permanent
conjection	coinjection
stickness	stickiness
prevalant	prevalent
verbage	verbiage
arbitary	arbitrary
cantalope	cantaloupe
weired	wired
obtaine	obtain
dispised	dispise
etimology	etymology
expell	expel
interprete	interpret
practitoner	practitioner
distopia	dystopia
concequence	consequence
implemente	implement
similiar	similar
vunerable	vulnerable
smush	smash
dimentia	dementia
configulation	configuration
torelance	tolerance
editted	edited
temporaly	temporarily
confort	comfort
ignor	ignore
aligne	align
follow	followed
expedit	expedite
mesentry	mesentery
capasity	capacity
greatful	grateful
detaile	detail
infinate	infinite
rendevous	rendezvous
resistent	resistant
describ	describe
oogle	ogle
excute	execute
inport	import
deligate	delegate
rememberance	remembrance
goverment	government
proceeder	procedure
woop	whoop
inovation	innovation
threatning	threatening
spuare	square
confortable	comfortable
effection	affection
bely	belly
controll	control
dictat	diktat
imortal	immortal
reccomend	recommend
condence	condense
aqcuire	acquire
auther	author
conclud	conclude
landload	landlord
elicite	elicit
	haplography
compair	compare
thourough	thorough
irreplacable	irreplaceable
nuture	nurture
	Google
anthropod	arthropod
exersize	exercise
incure	incur
creedence	credence
chiken	chicken
determind	determined
atomosphere	atmosphere
amplitube	amplitude
harrass	harass
suttle	subtle
psuedo	pseudo
accomodate	accommodate
cource	course
haching	hatching
configration	configuration
abberant	aberrant
tought	taught
studys	studies
exageration	exaggeration
expresse	express
congnitive	cognitive
suport	support
Beninacasa	Benincasa
oppurtunity	opportunity
corespond	correspond
incurr	incur
gazookus	gadzooks
preception	perception
complate	complete
perspect	perspective
expecially	especially
recentry	recently
floopy	floppy
aprove	approve
alterd	alter
polution	pollution
distruction	destruction
difinitely	definitely
agressive	aggressive
joyfull	joyful
charactaristic	characteristic
quater	quarter
overwhelme	overwhelm
epitomy	epitome
divid	divide
indentity	identity
explict	explicit
diserve	deserve
aglee	agree
disect	dissect
	Scholar
achive	achieve
quitly	quietly
inclimate	inclement
indispensible	indispensable
absense	absence
representive	representative
uncertainity	uncertainty
recomend	recommend
arguement	argument
villian	villain
brake	break
vigourously	vigorously
buisness	business
embarass	embarrass
referer	referrer
dimentional	dimensional
congential	congenital
admitt	admit
masterbate	masturbate
resiliant	resilient
Gallileo	Galileo
relevent	relevant
persual	perusal
togather	together
conbine	combine
acrue	accrue
waildlife	wildlife
makeing	making
hydroscopic	hygroscopic
substancial	substantial
expidite	expedite
tailore	tailor
percieve	perceive
ommited	omitted
turblence	turbulence
withness	witness
conjuction	conjunction
impaire	impair
tence	tense
teached	taught
wreckless	reckless
deffer	defer
scine	scene
particuler	particular
grammer	grammar
dealed	dealt
explicity	explicitly
provid	provide
similer	similar
casuality	casualty
occure	occur
temperment	temperament
expantion	expansion
viron	virion
desparate	desperate
superintendant	superintendent
crutial	crucial
retreive	retrieve
radder	rudder
readly	readily
tornade	tornado
instraction	instruction
wheather	whether
perticularly	particularly
apprecation	appreciation
genious	genius
immeadiately	immediately
mascline	masculine
wich	Which
equivarent	equivalent
emmision	emission
hense	hence
occation	occasion
sence	sense
outweight	outweigh
analagous	analogous
apreciate	appreciate
obstrusive	obtrusive
powerfull	powerful
futhermore	furthermore
consumate	consummate
consession	concession
persever	persevere
organaize	organize
contruct	contract
inplement	implement
adoptor	adaptor
seperately	separately
designat	designate
compatability	compatibility
suspence	suspense
amygdale	amygdala
histrogical	histological
fullfill	fulfill
came	come
ajust	adjust
decieve	deceive
desease	decease
identicial	identical
procedes	proceeds
declear	declare
recognization	recognition
proceded	proceeded
definately	definitely
aquit	acquit
gurantee	guarantee
preffer	prefer
flourine	fluorine
colleages	colleagues
comtemplate	contemplate
suprised	surprised
lengthly	lengthy
accessive	excessive
conbination	combination
highlite	highlight
perticular	particular
imagin	imagine
referr	refer
pursure	pursuer
directe	direct
forcus	focus
leasure	leisure
especialy	especially
refrect	reflect
Coinside	coincide
harb	herb
replacable	replaceable
alchol	alcohol
headquater	headquarter
considere	consider
resourse	resource
stablize	stabilize
commite	committee
particulary	particularly
analize	analyze
accesible	accessible
disolve	dissolve
impliment	implement
procede	proceed
persistant	persistent
forebearance	forbearance
alway	always
athiest	atheist
amature	amateur
maked	make
creat	create
colleage	colleague
	guise
repeatation	repitition
kintergarden	kindergarden
perticipate	participate
faciliate	facilitate
rised	rise
persue	pursue
adress	address
making	marking
preceed	precede
elaborative	elaborate
assesment	assessment
administeration	administration
liase	liaise
pursuade	persuade
solicite	solicit
occassionally	occasionally
separete	separate
insistance	insistence
belive	believe
rular	ruler
tenous	tenuous
whilist	whilst
implemention	implementation
opthalmologist	ophthalmologist
permissable	permissible
parenthese	parenthesis
commodate	accommodate
accessability	accessibility
propotional	proportional
equinoxe	equinox
relavant	relevant
dispise	despise
presumptious	presumptuous
inproper	improper
structual	structural
accomodating	accommodating
plung	plunge
dispite	despite
stedily	steadily
delineat	delineate
deterr	deter
indentified	identified
hitted	hit
examin	examine
loyality	loyalty
highlited	highlighted
constract	construct
compromize	compromise
retarted	retarded
abandone	abandon
excist	exist
annualy	annually
gradiation	gradation
supression	suppression
comparision	comparison
costom	custom
retrive	retrieve
altanative	alternative
preseeding	preceding
superseed	supersede
distruct	destruct
compatable	compatible
releave	relieve
agress	aggress
liek	like
aforemention	aforementioned
liason	liaison
bagage	baggage
consious	conscious
occurr	occur
surpress	suppress
comodity	commodity
rerated	related
anchore	anchor
transfered	transferred
happyness	happiness
for	take
damege	damage
arrangment	arrangement
excution	execution
abstruct	abstract
concider	consider
emcompass	encompass
haplography	Missippi
oppotunity	opportunity
emperical	empirical
withdrow	withdraw
frequentry	frequently
underlied	underlay
cresent	crescent
inprove	improve
genuin	genuine
definiton	definition
entery	entry
verfication	verification
smithereen	smithereens
editting	editing
existance	existence
interpretor	interpreter
incurre	incur
turbulance	turbulence
awarenes	awareness
aweful	awful
atribute	attribute
ordinaly	ordinary
SVPC	supraventricular
refridgerator	refrigerator
yeild	yield
difine	define
propery	properly
hayday	heyday
requir	require
concious	conscious
bycicle	bicycle
spose	suppose
hilighted	highlighted
disasterous	disastrous
interresting	interesting
doctorine	doctrine
futher	further
reconnaisance	reconnaissance
dissapointed	disappointed
conpetitor	competitor
arrengement	arrangement
disturbe	disturb
inhabitat	inhabitant
discription	description
responsability	responsibility
servicable	serviceable
pitty	pity
cancell	cancel
strech	stretch
conbat	combat
aformentioned	aforementioned
familiality	familiarity
stedy	steady
compell	compel
fablic	fabric
recind	rescind
remined	remained
fanction	function
propotion	proportion
disregulation	dysregulation
corelation	correlation
